조성환	Cho Sŏng-hwan
정윤희	Chǒng Yunhǔi
장운수	Chang Unsu
정몽구	Chŏng Mongku
장태석	Chang T'aesŏk
김성현	Kim Sŏnghyŏn
김철민	Kim Ch'ŏl-min
추송웅	Chu Song-Wŏng
고예림	Ko Yerim
신영석	Sin Yŏng-sŏk
홍순영	Hong Sunyŏng
변병주	Pyŏn Pyŏng-chu
최재수	Ch'ae Chae-su
지소연	Chi Soyŏn
문희준	Mun Hŭi-jun
허경환	Hŏ Kyŏng-hwan
정상진	Chŏng Sangjin
염수정	Yŏm Suchŏng
김홍복	Kim Hongbok
이영민	Ri Yŏngmin
장희진	Chang Hŭichin
최종환	Ch'oe Chonghwan
하승진	Ha Sŭngjin
장우혁	Chang Uhyŏk
정홍원	Chŏng Hongwŏn
홍진호	Hong Chin-ho
홍진후	Hong Chin-hu
김영남	Kim Yŏng-nam
김주영	Kim Chuyŏng
일진	IlChin
서혜린	Sŏ Hyerin
김신명숙	Gimsin Myeongsuk
사언	Saŏn
조인성	Cho Insŏng
이재원	Ri Chaewŏn
주기환	Chu K‘i-hwan
조영증	Cho Yŏngjŭng
전재연	Chŏn Chae-yŏn
손시헌	Son Si-hŏn
하석주	Ha Sŏkju
오규옥	O Kyuok
지익주	Chi Ig-chu
문성민	Mun Sŏngmin
황정오	Hwang Jeongo
이재우	Ri Chaeu
김소혜	Kim So-hye
한동진	Han Tong-chin
김승표	Kim Sŭngp'yo
이승엽	Ri Sŭngyŏp
김상호	Kim Sangho
이승기	Ri Sŭnggi
이호응	Ri Ho-ŭng
장은정	Chang Ŭn-jŏng
유재석	Yu Chae-sŏk
손담비	Son Tam-bi
이원희	Yi Wŏn-hŭi
조성기	Cho Sŏng-gi
봉중근	Pong Chung-gŭn
이나영	Yi Nayŏng
공성진	Kong Sŏngjin
여범규	Yŏ Pŏmgyu
은미희	Ŭn Mihŭi
김하성	Kim Ha-sŏng
최은경	Ch'oe Ŭn'gyŏng
김호곤	Kim Ho-gon
이준호	Ri Chunho
이영록	I Yŏngnok
홍길동	Hong Kil-tong
김준곤	Kim Chun'gon
어연순	Ŏ Yŏn-sun
박남열	Pak Nam-yŏl
강정훈	Kang Chŏnghun
성백인	Sǒng Paeg-in
김용준	Kim Yong-jun
박지성	Pak Chisŏng
박경두	Pak Kyŏngdu
조우진	Cho Ujin
조현오	Cho Hyŏn o
청원	Ch'ŏngwŏn
이희호	Yi Hŭiho
차두리	Ch'a Turi
정광민	Chŏng Kwangmin
박이문	Pak Imun
정재형	Jŏng Jae-hyŏng
임형주	Im Hyŏngju
이경규	I Kyŏng-kyu
백건우	Paek Kŏn-u
이수근	I Sugŭn
박상영	Pak Sangyŏng
윤계상	Yun Kye-sang
조성진	Cho Sŏngjin
유남규	Yu Namgyu
노회찬	No Hoech'an
안대현	An Tae-hyŏn
임태희	Im T'aehŭi
정한	Chŏng Han
정용주	Chŏng Yong-chu
고낙춘	Ko Rak-ch'un
전효성	Chŏn Hyo-sŏng
한현희	Han Hyŏnhŭi
이은실	Yi Ŭn-sil
백명선	Paek Myŏngsŏn
남승룡	Nam Sŭngnyong
이승현	Yi Sŭnghyŏn
장선우	Chang Sŏnu
하리수	Harisu
김동수	Kim Tong-su
임창용	Rim Ch'ang-yong
현영민	Hyŏn Yŏng-min
홍명보	Hong Myŏng-bo
곽민정	Kwak Minjŏng
성시경	Sŏng Si(-)kyŏng
홍익표	Hong Ikp'yo
고은비	Ko Ŭnbi
하준임	Ha Chun-im
염경엽	Yŏm Kyŏng'yŏp
조성환	Cho Sŏnghwan
강재섭	Kang Chaesŏp
김병주	Kim Pyŏng-ju
정동호	Chŏng Tongho
여황	Yŏhwang
이충희	Yi Ch'unghŭi
김형욱	Kim Hyŏng-uk
박수홍	Pak Su-hong
이범호	I Pŏm-ho
하강진	Ha Kangchin
김인식	Kim Insik
김기태	Kim Kit'ae
김병선	Kim Pyŏngsŏn
최우혁	Ch‘oe U-hyŏk
김동희	Kim Tonghŭi
문재인	Mun Chaein
장의종	Chang Ŭi-chong
조훈현	Cho Hun-hyŏn
백상승	Paek Sang-sǔng
강봉균	Kang Ponggyun
김태균	Kim T'aegyun
송태곤	Song T'ae-kon
서윤복	Sŏ Yunbok
홍경민	Hong Kyŏng-min
송아	Song'a
이재명	Yi Chaemyŏng
한대화	Han Taehwa
김희진	Kim Hŭi-jin
이균영	Yi Kyunyŏng
손지현	Son Chi-hyŏn
윤태일	Yun T‘aeil
노경은	Ro Kyŏngŭn
정준연	Chŏng Chunyŏn
유희열	Yu Hŭi-yŏl
최민호	Ch'oe Minho
주현미	Chu Hyŏn-mi
박영훈	Pak Yeong-hun
나경	Na Kyŏng
이준	Yi Chun
김명성	Kim Myŏng-sŏng
황문기	Hwang Mun'gi
윤상규	Yun Sanggyu
박지윤	Pak Chiyun
이승용	Ri Sŭngyong
장기하	Chang Ki(-)ha
박나래	Pak Narae
김용국	Kim Yongguk
채수찬	Ch'ae Such'an
원희룡	Wŏn Hŭiryong
윤현	Yun Hyŏn
김시우	Kim Siu
박요한	Pak Yohan
윤병세	Yun Byŏngse
강문규	Kang Mun'gyu
박태환	Pak T'ae-hwan
김원일	Kim Wŏnil
김무성	Kim Mu-sŏng
홍성호	Hong Sŏngho
박성현	Pak Sŏng-hyŏn
김 C	Kim C
김광수	Kim Kwangsu
김민우	Kim Min-U
김태균	Kim T'ae-gyun
정현숙	Chŏng Hyŏnsuk
심상정	Sim Sangjŏng
김별아	Kim Pyŏra
이세진	I Sejin
남기일	Nam Ki-il
선보미	Sŏn Pomi
이승렬	Ri Sŭngnyŏl
박정권	Pak Chŏnggwŏn
최병광	Ch'oe Pyŏnggwang
황석근	Hwang Sŏkkŭn
문정훈	Mun Chŏnghun
고은태	Ko Ŭnt'ae
이선웅	Yi Sŏnung
안상영	An Sangyŏng
원유철	Wŏn Yuch'ŏl
김민재	Kim Minjae
진대제	Chin Tae-je
임정현	Im Chŏnghyŏn
황교충	Hwang Kyoch'ung
복거일	Pok Kŏ-il
김정숙	Kim Chŏng-suk
한명숙	Han Myŏngsuk
김덕중	Kim Tŏkchung
조선작	Cho Sŏn-chak
허윤정	Hŏ Yunjŏng
엄기영	Ŏm Kiyŏng
정운	Chŏng Un
안용우	An Yongu
유시민	Yu Simin
안대희	An Taehŭi
최다슬	Ch'oe Dasŭl
박호진	Pak Ho-chin
조가경	Cho Kagyǒng
시림산인	Sirimsanin
박소진	Pak Sojin
웬디	Wen-ti
고석창	Ko Sŏk-ch‘ang
김주리	Kim Chu-ri
주영광	Chu Yŏnggwang
이용훈	Ri Yonghun
박종훈	Pak Chong-hun
윤증현	Yun Chŭnghyŏn
이종욱	Yi Chong-uk
한혜리	Han Hye-ri
박진영	Pak Chinyŏng
심재원	Sim Chae-wŏn
이문열	Yi Munyŏl
나상욱	Na Sang-uk
정진호	Chŏng Chinho
최정한	Ch'ae Chǒnghan
최경환	Ch'oe Kyŏng-hwan
하성민	Ha Sŏngmin
길성준	Kil Sŏng-jun
서성준	Sŏ Sŏngjun
김규민	Kim Kyumin
류현진	Ryu Hyŏn-jin
박선미	Pak Sŏnmi
이유영	I Yu-yŏng
정재훈	Chŏng Chae-hun
최철순	Ch'oe Ch'ŏlsun
이한구	I han-ku
강미선	Kang Misŏn
박정화	Pak Chŏng-hwa
최명훈	Ch'oe Myŏnghun
정조국	Chŏng Choguk
선우휘	Sŏnu Hwi
천명훈	Cheon Myeong-hun
김관용	Kim Kwannyong
변성환	Pyŏn Sŏng-hwan
김연지	Kim Yŏn-ji
조병화	Cho Pyŏnghwa
박세웅	Pak Seung
유병훈	Yu Pyŏnghun
남나영	Nam Nayŏng
금남	Kŭmnam
배효성	Pae Hyo-sŏng
정의도	Chŏng Ŭido
김민규	Kim Min'gyu
정운찬	Chŏng Unch'an
전나영	Chŏn Nayŏng
고원용	Ko Wŏnyong
김영민	Kim Yŏng-min
정대선	Chŏng Tae-sŏn
임정호	Rim Chŏng-ho
이종범	Yi Chongbŏm
조경란	Cho Kyŏngnan
한승연	Han Sŭng-yŏn
민경훈	Min Gyeong-hun
강민수	Kang Minsu
장현수	Chang Hyŏnsu
고종수	Ko Chongsu
김선우	Kim Sŏn-u
송민영	Song Minyŏng
조용철	Cho Yong-ch‘ŏl
노시환	Ro Si-hwan
임경완	Rim Kyŏng-wan
안성민	An Sŏng-min
최인호	Ch'oe In Ho
강영숙	Kang Yŏngsuk
박영선	Pak Yŏngsŏn
나경원	Ra Kyŏngwŏn
박용욱	Pak Yong-uk
충정	Ch'ung-jŏng
김예원	Kim Ye-wǒn
최금강	Ch'oe Kŭm-gang
최은성	Ch'oe ŭn-sŏng
이차만	I Ch'a-man
조용형	Cho Yonghyŏng
하승준	Ha Sŭngjun
이윤열	Yi Yun-yŏl
장외룡	Chang Oe-ryong
후광	Hugwang
함기용	Ham Kiyong
이범석	Yi Pŏmsŏk
김설현	Kim Sŏlhyŏn
김민수	Kim Minsu
조범현	Cho Pŏmhyŏn
강대성	Kang Tae-sŏng
송신영	Song Sin-yŏng
김정렴	Kim Chŏng-nyŏm
고근태	Ko Kŭnt'ae
진민호	Chin Minho
배유나	Pae Yuna
조재기	Cho Chaegi
박기혁	Pak Kihyŏk
김영욱	Kim Yŏnguk
이상기	Ri Sang-gi
박지원	Pak chiwŏn
장남석	Chang Nam-Sŏk
양준혁	Yang Chunhyŏk
주재덕	Chu Chae-tŏk
강민혁	Kang Min-hyŏk
장창선	Chang Ch'ang-sŏn
우원식	U Wŏnsik
조영철	Cho Yŏng-ch'ŏl
지상준	Chi Sangjun
손광민	Son Kwangmin
노아름	No Arŭm
백성동	Paek Sŏngdong
송지은	Song Ji-ŭn
박금이	Pak Kŭmi
백영철	Paek Yŏngch'ŏl
안다니엘	An Taniel
국선영	Kuk Son-Yong
김미현	Kim Mi-hyŏn
정민태	Chŏng Mint'ae
정인환	Chŏng Inhwan
장은경	Chang Ŭn'gyŏng
유성제	Yu Sŏngje
박경완	Pak Kyŏngwan
임종인	Im Chong-in
강금실	Kang Kŭm-sil
신두호	Sin Tuho
윤남진	Yun Nam-jin
김주찬	Kim Chu-ch'an
차경복	Ch'a Kyŏngbok
백원철	Paek Wŏnch'ŏl
변호영	Pyŏn Hoyŏng
박찬용	Pak Ch'an-yong
최선호	Ch'oe Sŏnho
박산다라	Pak Sandara
김재범	Kim Chae-bŏm
이인제	Ri In-je
최정	Ch'oe Chŏng
정기동	Chŏng Kidong
박영우	Pak Yŏng'u
유기흥	Ryu Kihŭng
김진국	Kim Chin'guk
정진혁	Chŏng Chinhyŏk
강수일	Kang Su-il
조성달	Cho Sŏngdal
운정	Unjŏng
한지환	Han jiwhan
조태근	Jo Taekeun
춘성	Chunsŏng
최승현	Ch'oe Sŭnghyŏn
이상돈	I Sangton
김영광	Kim Yŏnggwang
김지훈	Kim Chihun
최준석	Ch'oe Chun-sŏk
이선호	I Sŏnho
정유석	Chŏng Yu-sŏk
정호정	Chŏng Hochŏng
전혜숙	Chŏn Hyesuk
천호선	Ch'ŏn Hosŏn
정세현	Chŏng Sehyŏn
안상미	An Sang-mi
정종관	Chŏng Chongkwan
안현식	An Hyŏn-sik
박예은	Pak Yeŭn
박희성	Pak Huisŏng
김인경	Kim In-kyŏng
윤경신	Yun Kyŏngsin
정일미	Chŏng Ilmi
한찬희	Han Ch'anhŭi
안소희	An Sohŭi
차홍	Ch'a Hong
구본길	Ku Pon'gil
정찬성	Chŏng Ch‘an-sŏng
이대은	Ri Daeeun
류제국	Ryu Cheguk
이보람	I Poram
이윤철	Ri Yun-ch'ŏl
중수	Chungsu
유석	Yusŏk
염한웅	Yeom Hanung
이슬	Ri Sŭl
백우현	Paek Uhyŏn
정성룡	Chŏng Sŏngnyong
김해종	Kim Haejong
박초아	Pak Ch'oa
최운정	Ch'oe Un jŏng
민선예	Min Sŏn-ye
김남주	Kim Namchu
김성일	Kim Sŏng-il
전칠성	Chŏn Ch'ilsŏng
고우리	Ku Uri
김우중	Kim U-Choong
편조	P'yŏnjo
윤광웅	Yun Kwang-ung
이우환	I Hhwan
구하라	Ku Ha-ra
안병직	An Pyŏng-jik
한홍기	Han Honggi
소유	Soyou
박희상	Pak Hŭisang
오은석	O Ŭnsŏk
이다영	Ri Ta-yŏng
조선진	Cho Sŏn-chin
엄팔용	Ŏm Pal-yong
공민지	Kong Minchi
이청천	Yi Ch'ŏngch'ŏn
최종길	Ch'oe Chong-kil
서동원	Sŏ Tong-wŏn
박성원	Pak Sŏng-wŏn
김성주	Kim Sŏngu
왕기춘	Wang Kich‘un
방대두	Pang Tae-du
이장수	Yi Chang-su
이낙연	I Nak-yŏn
박도헌	Pak To-hŏn
홍철	Hong Ch'ŏl
임용근	Im Yonggǔn
김장훈	Kim Changhun
방준영	Pang Chunyŏng
현기영	Hyŏn Kiyŏng
김용산	Kim Yong-san
강재순	Kang Jae-soon
아이유	Aiyu
임지훈	Rim Chi-hun
정진수	Chŏng Chin-su
배한라	Pae Halla
정한해	Chŏng Hanhae
강슬기	Kang Sŭlki
김성근	Kim Sŏnggŭn
김평석	Kim P'yŏngsŏk
정찬동	Chŏng Ch'an
이기백	Yi Ki-baek
윤명준	Yun Myŏng-jun
박홍근	Pak Honggŭn
안동혁	An Donghyŏk
강재원	Kang Jaewŏn
김춘수	Kim Ch'un-su
고윤하	Ko Yunha
오승환	O Sŭng-hwan
김광현	Kim Kwanghyŏn
안재훈	Ahn Jaehoon
서강욱	Sŏ Kanguk
정의윤	Chŏng Ŭiyun
서하진	Sŏ Hajin
장영란	Chang Yŏngnan
이두연	Yi Tuyŏn
정은선	Chŏng Ŭnsŏn
강선규	Kang Sǒn'gyu
고아라	Ko Ah-ra
김대은	Kim Tae-ŭn
이봉출	Ri Pongch'ul
이종석	Yi Chongsŏk
안덕수	An Tŏksu
조소현	Cho Sohyŏn
조진호	Cho Chin-ho
김호직	Kim Hojik
강신재	Kang Sin-jae
송영길	Song Yŏngkil
김주영	Kim Juyŏng
윤동식	Yun Tong-sik
박중규	Pak Chunggyu
전원근	Chŏn Wŏn-Kŭn
박철순	Pak Ch'ŏlsun
이정수	I Chŏngsu
송진우	Song Chinu
이은별	Yi Ŭn-byŏl
박찬수	Pak Ch'ansu
장현식	Chang Hyŏn-sik
최철한	Ch'oe Ch'ŏl-han
김태영	Kim T'ae-yŏng
문대성	Mun Taesŏng
경사	Kyŏngsa
강문권	Kang Mun'gwŏn
한그루	Han Kŭru
이정용	Ri Chŏngyong
오용기	O Yong-ki
조한승	Jo Hanseung
박동선	Pak Tongsŏn
박태민	Pak T'aemin
김동완	Kim Tong-wan
이태양	I T'aeyang
강감찬	Kang Kamch'an
이정신	I Chŏng-sin
최광현	Ch'oi Kwang'hyŏn
이선우	Yi Sŏn.u
김승희	Kim Sŭnghŭi
변영준	Pyŏn Yŏngjun
심재민	Sim Chaemin
정동기	Chŏng Tonggi
배민희	Pae Minhŭi
최시원	Ch'oe Siwŏn
황재훈	Hwang Chaehun
김완섭	Kim Wan-sǒp
추미애	Ch'u Miae
김근태	Kim Kŭnt'ae
송혜교	Song Hye-kyo
김준수	Kim Chun-su
이정은	Ri Chŏngŭn
최윤겸	Ch'oe Yun-kyŏm
우혜림	U Hye-rim
박소담	Pak Sotam
양상문	Yang Sangmun
조태용	Cho T'ae-yong
이지아	I Chi-a
최효진	Ch'oe Hyojin
최태욱	Ch'oe T'ae-uk
진갑용	Chin Kabyong
윤보라	Yun Pora
이정현	Ri Chŏnghyŏn
장소연	Chang Soyŏn
김동현	Kim Tonghyŏn
최희섭	Ch'oe Hŭisŏp
이상화	Ri Sanghwa
김부겸	Kim Pugyŏm
호란	Ch'oi Sujin
이동하	Yi Tong-ha
허영지	Hŏ Yŏngchi
최근식	Ch'ae Kŭnsik
곽경근	Kwak Kyŏng-kŭn
정의경	Chŏng Ŭigyŏng
송명근	Song Myŏnggŭn
김형주	Kim Hyŏngju
조민국	Cho Min-kuk
장혜숙	Chang Hye-suk
황지윤	Hwang Chiyun
이대호	Ri Tae-ho
장욱진	Chang Ukchin
김응룡	Kim Ŭngnyong
한국영	Han Kugyŏng
차학경	Ch'a Hak-kyŏng
장호철	Chang Hochŏl
공영선	Kong Yŏng-Sŏn
마광수	Ma Kwangsu
신태용	Sin T'ae-yong
안상현	An Sanghyŏn
곽가현	Kwak Ka-hyŏn
이민규	Ri Min'gyu
방시혁	Pang Sihyŏk
박병주	Pak Pyŏng-chu
강영걸	Kang Yŏng-gŏl
김영운	Kim Yŏng'un
홍영승	Hong Yŏngsŭng
이태호	I T'ae-Ho
김명수	Kim Myŏng-su
장효훈	Chang Hyo-hun
안창남	An Ch'ang-nam
백지훈	Paek Chi-hun
문정희	Mun Chŏnghŭi
황희태	Hwang Hŭit'ae
박중훈	Pak Chunghun
김용갑	Kim Yong-kab
정양석	Chŏng Yangsŏk
박미경	Pak Migyŏng
조인철	Cho Inch‘ŏl
이영무	Yi Yeŏng-mu
최인영	Ch'oe In-yŏng
노태원	No T'aewŏn
김수환	Kim Suhwan
박용진	Pak Yongjin
김재권	Kim Chaegwǒn
신명철	Sin Myŏngch'ŏl
조상우	Cho Sangu
김건모	Kim Kŏn-mo
김성배	Kim Sŏngbae
신재영	Sin Chae-yŏng
서희경	Sŏ Hŭi-gyŏng
나경손	Ra Kyŏngson
김국영	Kim Kugyŏng
강석경	Kang Sŏk'kyŏng
한강	Han Kang
장영희	Chang Yŏng-hŭi
문광은	Mun Kwang-ŭn
김민혜	Kim Minhye
박선주	Pak Sŏnju
전정린	Chŏn Chŏngnin
서보영	Sŏ Poyŏng
최일남	Ch'oe Il-nam
서건창	Sŏ Kŏnch'ang
장신권	Chang Sin'gwŏn
김병국	Kim Pyǒngguk
신일용	Sin Iryong
김유빈	Kim Yupin
박준형	Pak Chun-hyŏng
강만수	Kang Man-su
정우영	Chŏng Uyŏng
백상원	Paek Sang-wŏn
홍숙자	Hong Sukja
조치훈	Cho Ch'i-hun
이남미	Ri Nam-mi
신봉선	Sin Pongsŏn
정동훈	Chŏng Tonghun
황교안	Hwang Kyo-an
윤상현	Yun Sanghyǒn
윤지웅	Yun Chiung
전준형	Cheong Chunghyŏng
정세균	Chŏng Segyun
박항서	Pak Hang-sŏ
김수준	Kim Su-chun
최태진	Ch'oe T'aejin
김동섭	Kim Tong-sŏp
운석	Unsŏk
김영희	Kim Yŏnghŭi
박창현	Pak Ch'anghyŏn
정동영	Chǒng Tongyǒng
방용국	Pang Yong-kuk
양신영	Yang Sinyŏng
정민주	Chŏng Min-chu
장현규	Chang Hyŏnkyu
정광식	Chŏng Kwangsik
이해찬	I Haech'an
최순호	Ch'oe Sun-ho
강상우	Kang Sangu
이찬해	Yi Ch'anhae
안재형	An Chae-hyŏng
김만식	Kim Mansik
김수경	Kim Sugyŏng
문희상	Mun Hŭisang
조지훈	Cho Chihun
정석민	Chŏng Sŏngmin
권여선	Kwŏn Yŏsŏn
김윤식	Kim Yunsik
신경숙	Sin Kyŏngsuk
안호영	An Hoyŏng
김운성	Kim Unsŏng
장정	Chang Chǒng
이원석	Ri Wŏn-sŏk
이대수	Ri Tae-su
김재한	Kim Chaehan
이자스민	Yi Chasŭmin
박광일	Pak Kwangil
황정은	Hwang Chŏng'ŭn
김신영	Kim Sinyŏng
박한용	Pak Han-yong
정국진	Chŏng Kukchin
김정빈	Kim Chǒngbin
윤경병	Yun Kyŏngbyŏng
신팔균	Sin P‘al-kyun
설리	Sŏl-ri
김진우	Kim Chin-u
최덕근	Ch'oe Tŏk'gŭn
안시현	An Sihyŏn
백종환	Paek Chonghwan
문세윤	Mun Seyun
이광희	I Kwanghŭi
유명환	Yu Myŏnghwan
강동구	Kang Dongku
바다	Pada
이혜리	Yi Hyeri
강동윤	Kang Tongyun
우규승	U Kyusŭng
강호동	Kang Ho-dong
H-유진	H-Yuchin
배승진	Pae Sŭngjin
김성한	Kim Sŏnghan
지석진	Chi Sŏkchin
최윤칠	Ch'oe Ryunch'il
최원권	Ch'oe Wŏn-gwŏn
안영명	An Yŏngmyŏng
최용수	Ch'oe Yongsu
최나연	Choi Na Yŏn
이태양	Ri T'ae-yang
박병호	Pak Pyŏng-ho
최춘옥	Ch'oe Ch'un-ok
권영길	Kwŏn Yŏnggil
정경호	Chŏng Kyŏng-ho
정수영	Chŏng Suyŏng
조형익	Cho Hyŏngik
김진희	Kim Chin-hŭi
철기	Ch'ŏlgi
서유헌	Sŏ Yuhŏn
이해리	Yi Hae-ri
김성환	Kim Sŏnghwan
오영수	O Yŏng-su
김지하	Kim Chiha
정하나	Chŏng Hana
임덕준	Rim Tŏkchun
송보배	Song Pobae
박영대	Pak Yŏng-tae
백인천	Paek Inch'ŏn
석정아	Sŏk Chŏng'a
조중연	Cho Chung-Yun
김찬미	Kim Ch'anmi
이민영	Yi Minyǒng
키썸	Kissŏm
김장수	Kim Chang-su
서재덕	Sŏ Chaedŏk
고대우	Ko Taeu
이영욱	Ri Yŏnguk
나해령	Na Haeryŏng
이순복	Ri Sun-bok
이제하	Ri Cheha
나현정	Ra Hyŏn-jŏng
황사손	Hwangsason
서현진	Sŏ Hyŏn-chin
강진욱	Kang Chin-uk
유원상	Ryu Wŏnsang
당예서	Tang Yesŏ
강희건	Kang Hŭigŏn
황우석	Hwang Usŏk
고경수	Ko Kyŏngsu
이영훈	Ri Yŏng-hun
변천사	Pyŏn Ch'ŏn-sa
윤윤수	Yun Yun-su
오윤	O Yun
송희채	Song Hŭich'ae
조정권	Cho Chŏng-gwŏn
한인상	Han Insang
강정호	Kang Chŏngho
이정식	Ri Chŏngsik
춘강	Ch'ungang
이기형	Yi Ki-hyŏng
이채연	Yi Ch'ae-yŏn
김시진	Kim Sijin
이태훈	Ri T'aehun
정의선	Chŏng Ŭisŏn
곽대성	Kwak Tae-sŏng
최현	Ch'oe Hyŏn
이청준	Yi Ch'ong-chun
김종창	Kim Chong-chang
황무규	Hwang Mugyu
최진수	Ch'ae Chin-su
정상훈	Chŏng Sanghun
이완구	I Wang-ku
장종훈	Chang Chonghun
정영문	Chŏng Yŏng-mun
지율	Chiyul
민병헌	Min Pyŏnghŏn
양용은	Yang Yongŭn
김세정	Kim Se-chŏng
김지현	Kim Chihyŏn
오주원	O Chuwŏn
윤승현	Yun Sŭnghyŏn
김상현	Kim Sanghyŏn
장윤희	Chang Yunhŭi
이학주	Ri Hakchu
황병주	Hwang Pyŏngch'u
최진철	Ch'oe Chin-ch'ŏl
정다연	Chŏng Ta-yŏn
김세영	Kim Seyŏng
이종욱	I Chong'uk
이만수	Ri Mansu
석은미	Sŏk ŭn-mi
방신혜	Pang Sinhye
유동근	Yu Tonggŭn
장대환	Chang Taehwan
정근우	Chŏng Kŭn-u
김종운	Kim Chong-un
최병현	Ch'oe Pyŏnghyŏn
장길혁	Chang Kirhyŏk
최영준	Ch‘oe Yŏng-chun
우범곤	U Pǒmgon
김정남	Kim Chŏng-nam
김향숙	Kim Hyangsuk
은지원	Ŭn Chiwŏn
한창우	Han Chang'u
김현수	Kim Hyŏn-su
이용철	Yi Yong-ch'ǒl
정석근	Chŏng Sŏk-kŭn
최성용	Ch'oe Sŏng-yong
이홍기	Yi Hong-ki
김정환	Kim Chŏnghwan
조현두	Cho Hyŏn-tu
손학규	Son Hak-kyu
강덕수	Kang Tŏksu
이규원	Yi Kyu-wŏn
박건하	Pak Kŏn-ha
공지영	Kong Chiyŏng
경극	KyeungKeuk
조귀재	Cho Kwi-chae
김종곤	Kim Chongkon
심석희	Sim Sŏkhŭi
진보라	Chin Pora
김태호	Kim T'aeho
최경주	Ch'oe Kyŏng-ju
조용필	Cho Yongp'il
서정원	Sŏ Chŏngwŏn
홍정남	Hong Chŏngnam
리기붕	Ri Kibung
부영태	Pu Yŏngtae
박지원	Pak chi-wŏn
정성훈	Chŏng Sŏnghun
김두천	Kim Tuch'ŏn
박영희	Pak Yǒnghǔi
송종국	Song Chongguk
권보아	Kwŏn Poa
구성윤	Ku Sŏng-yun
정몽준	Chŏng Mongjun
민병갑	Min Pyŏng-gap
오지환	O Chihwan
박재홍	Pak Chaehong
기동민	Ki Tongmin
박준상	Pak Chun-sang
박지은	Pak Chiŭn
정윤성	Chŏng Yun-sŏng
최무림	Ch'oe Mu-rim
선동렬	Sŏn Tongnyŏl
손석희	Son Sŏkhŭi
홍정호	Hong Chŏngho
공민현	Kong Minhyŏn
오윤경	O Yun'gyŏng
최영근	Ch'oe Yŏnggŭn
전여옥	Chŏn Yŏ-ok
허용준	Hŏ Yongjun
최양도	Choe Yangdo
신건	Sin Kŏn
전경준	Chŏn Kyŏng-jun
정훈	Chŏng Hun
김철호	Kim Ch'ŏrho
조광래	Cho Kwang-Rae
최호정	Ch'oe Ho-chŏng
서영교	Sŏ Yŏnggyo
김승옥	Kim Sŭngok
손연재	Sohn Yŏn-chae
이우정	Yi Wujong
박경원	Pak Kyŏng'wŏn
이임학	Yi Imhak
왕정훈	Wang Chŏng-hun
임정우	Rim Jŏng-u
치우	Ch'iu
김용식	Kim Yongsik
박정배	Pak Chŏngbae
주순란	Chu Sullan
조윤옥	Cho Yun-ok
김두현	Kim Tuhyŏn
김종호	Kim Chong-ho
조규현	Cho Kyu-hyŏn
심재홍	Sim Chae-hong
성낙군	Sŏng Nakgun
마해영	Ma Haeyŏng
박석민	Pak Sŏngmin
이헌재	Yi Hǒn-jae
이진상	Yi Chinsang
정문경	Chŏng Mun'gyŏng
인재근	In Chaekŭn
이윤영	Yi Yunyŏng
전봉성	Chŏn Pongsŏng
최민정	Choe Minjŏng
천정배	Ch'ŏn Chŏngbae
조원희	Cho Wŏn-hŭi
정정수	Chŏng Chŏngsu
홍지연	Hong Chiyŏn
MC 몽	MC Mong
권민아	Kwŏn Mina
유현	Yu Hyŏn
오하영	O Ha-yŏng
정민석	Chŏng Minsŏk
박인원	Pak Inwŏn
이종원	Ri Chongwŏn
은희경	Ŭn Hŭigyŏng
최정민	Ch'oe Chŏngmin
안선주	An Sŏnju
이창호	Ri Ch'ang-ho
최문식	Ch'oe Mun-sik
조성준	Cho Sŏngchun
고성국	Ko Sŏng-guk
김동진	Kim Tongjin
정병탁	Jung Byung-tak
이성훈	Ri Sŏnghun
전태현	Chŏn T'aehyŏn
이호성	I Hosŏng
강철	Kang Ch'ŏl
유승민	Yu Sŭngmin
유봉형	Yu Ponghyŏng
공상정	Kong Sangjŏng
이재오	Yi Chae-o
김종국	Gim Jong-guk
박찬영	Pak Ch'anyŏng
최종옥	Ch'oe Chongok
김승규	Kim Sŭnggyu
김용	Kim Yong
김봉만	Kim Pongman
차태성	Ch'a T'aesŏng
장하준	Chang Hachun
성운	Seongun
김슬기	Kim Sŭl-ki
정다래	Chŏng Tarae
정용화	Chŏng Yonghwa
박승현	Pak Seung-hyeon
이도희	I Tohŭi
안현수	An Hyŏnsu
옥주현	Ok Chuhyŏn
방민아	Pang Min-a
김효연	Kim Hyoyŏn
윤보현	Yun Bohyŏn
김석원	Kim Sŏgwŏn
윤치영	Un Chi'-yŏng
황일수	Hwang Il-Su
정두언	Chŏng Duŏn
장윤정	Chang Yunjŏng
배일환	Pae Irhwan
정다훤	Cheong Tahwŏn
최영진	Ch'oe Yŏng-jin
임 진석	Im Chin-sŏk
권소현	Kwŏn Sohyŏn
지상욱	Chi Sanguk
변준범	Pyŏn Chun-bŏm
윤석호	Yun Sŏkho
곽이경	Kwak Yigyong
김용만	Kim Yongman
하길종	Ha kil-chong
김영아	Gim Yeonga
박종호	Pak Chongho
박정아	Pak Chŏng-a
이종걸	Ri Chonggŏl
이태식	Yi T'aesik
김황식	Kim Hwangsik
서경석	Sŏ Kyŏngsŏk
청마	Ch'ŏngma
한송	Han Song
남현우	Nam Hyŏnu
김기황	Kim Kihwang
장필준	Chang P'iljun
김종철	Kim Chong-ch'ŏl
전병국	Chŏn Pyŏn-guk
김 재환	Kim Chae-hwan
박현선	Pak Hyŏnsŏn
김원권	Kim Wŏn'gwŏn
장효희	Chang Hyohui
황병기	Hwang Pyŏngki
최성현	Ch'oe Sŏng-hyŏn
김을동	Kim Ŭl-dong
걍용석	Kang Yongsŏk
김선빈	Kim Sŏnbin
신미나	Shin Mi-na
정호진	Chŏng Hojin
최용신	Ch'oe Yongsin
김연아	Kim Yŏna
준케이	Jun Ke-i
김승연	Kim, Sǔngyŏn
신재민	Sin Jaemin
진영	Chin Yŏng
허정무	Hŏ Chŏng-mu
최광	Ch'oe Kwang
고진영	Ko Chinyŏng
남지연	Nam Chiyŏn
이정후	I ijŏn-hu
고창성	Ko Ch'angsŏng
김효주	Kim Hyochu
윤미진	Yun Mijin
추화일	Ch'u Hwail
정혜림	Chŏng Hye-rim
김기훈	Kim Ki-hun
이진영	Yi Chinnyŏng
강수진	Kang Sujin
김동률	Kim Tongryul
홍진주	Hong Chinju
김태군	Kim T'ae-gun
황선홍	Hwang Sŏn-hong
공륙	Kongnyuk
정승화	Chŏng Sŭnghwa
김성문	Kim Sŏngmun
감한솔	Kam Hansol
황석호	Hwang Sŏkho
조남석	Cho Namsŏk
김준호	Kim Jun-ho
백민철	Paek Minch'ŏl
조원광	Cho Won-kwang
이소영	Ri So-yŏng
우선희	U Sŏnhŭi
신정락	Sin Chŏngnak
박용옥	Pak Yongok
효민	Hyomin
조홍규	Cho Hong-kyu
우규민	U Kyumin
박경림	Pak Kyŏng-nim
한선화	Han Sŏnhwa
장조윤	Chang Choyun
김승구	Kim Sŭnggu
최영일	Ch'oe Yŏng-il
변갑	Pyŏn'gap
이진	Yi Chin
안정환	An Chŏnghwan
고슬기	Go Seul-Ki
강경화	Kang Kyŏng'hwa
박세리	Pak Seri
이민성	Yi Min-sŏng
이승환	Yi Sŭng-hwan
이병근	Ri Pyŏnggŭn
류화영	Ryu Hwa-yŏng
김윤옥	Kim Yun'ok
정순옥	Chŏng Sunok
박상인	Pak Sangin
거산	Kŏsan
김진호	Kim Chin-ho
조재학	Cho Chaehak
박완서	Pak Wansŏ
인동	Indong
이후락	Yi Hurak
박원순	Pak Wŏnsun
윤기숙	Yun Kisuk
라파엘	Rap'ael
경우	Kyŏngu
일송	Ilsong
변경자	Pyŏn Kyŏngja
김유진	Kim Yu-chin
이동해	I Tong-hae
장성호	Chang Sŏngho
김희경	Kim Hǔigyǒng
오재일	O Chae-il
안철수	An Ch'ŏlsu
박광수	Pak Kwang-su
전지윤	Chŏn Chi-yun
이승철	Yi Sŭng-ch'ŏl
서유나	Sŏ Yuna
김진욱	Kim Chinuk
하니	Hani
안상수	An Sang-su
최승욱	Ch'oe Sŭnguk
안규백	An Kyubaek
정동하	Chǒng Tongha
이용훈	Yi Yonghun
조현	Cho Hyŏn
김태우	Kim T'ae-u
민윤기	Min Yunki
천운영	Ch'ŏn Unyŏng
박은주	Pak Ŭn-ju
이강조	Ri Kangjo
최성국	Ch'oe Sŏngguk
나나	Nana
김문수	Kim Munsu
박지연	Pak Chiyŏn
김원진	Kim Wŏnjin
박인비	Pak Inbi
서재응	Sŏ Chae-ŭng
권오곤	Kwŏn O-kon
육영수	Yuk Yŏngsu
최석재	Ch'oe Sŏkchae
김기범	Kim Kibŏm
최종덕	Ch'oe Chongdŏk
김정학	Kim Chŏng-hak
박승희	Pak Sŭnghŭi
박인천	Park In-chŏn
박세영	Pak Seyŏng
강민경	Kang Min'gyŏng
고건	Ko Kŏn
박경석	Pak Kyŏngsŏk
신영철	Sin Yŏngch'ŏl
김상욱	Kim Sanguk
조권	Cho Kwŏn
김창환	Kim Ch'anghwan
박이천	Pak Rich'ŏn
윤미경	Yun Migyŏng
김진숙	Kim Chinsuk
구자욱	Ku Chauk
신동	Sindong
이채린	I Ch'ae-rin
이대형	Ri Taehyŏng
고산	Ko San
고민우	Ko Min-u
김주원	Kim Chu-wŏn
정영환	Chŏng Yŏnghwan
조경숙	Cho Kyŏngsuk
윤채경	Yun Ch'ae-kyŏng
권용관	Kwŏn Yong-gwan
김경문	Kim Kyŏngmun
옥택연	Ok T'aegyŏn
최광희	Ch'oe Kwanghŭi
우양	Uyang
최강창민	Ch'oegang Ch'angmin
함은정	Ham Ŭnchŏng
심해인	Sim Haein
박혁순	Pak Hyŏksun
한덕수	Han Tŏk-su
유아라	Yu A-ra
조해룡	Cho Haeryong
이상훈	Ri Sang-hun
윤석민	Yun Sŏngmin
박병철	Pak Pyŏngch'ŏl
김지석	Kim Chisŏk
김우재	Kim U-jae
최인훈	Ch'oe Inhun
이성제	Ri Sŏngje
이지은	Yi Chiŭn
영친왕	Yŏngch'inwang
전가을	Chŏn Kaŭl
전성찬	Chŏn Sŏng-ch'an
정우람	Chŏng Uram
최영남	Ch'oe Yŏng-nam
백민철	Paek Min-ch'ŏl
김종인	Kim Chongin
조윤환	Cho Yun-hwan
테디 박	T'edi Pak
박신양	Pak Shin-yang
문태준	Mun T'aejun
함흥철	Ham Hŭng-ch‘ŏl
최동원	Ch'oe Tongwŏn
양파	Yangp' a
싸이	Ssai
정용훈	Chŏng Yonghun
임요환	Im Yo-hwan
리지	Ri-chi
조치효	Cho Ch'ihyo
조재진	Cho Chaejin
오윤석	O Yunsŏk
박근혜	Pak Kŭnhye
조용태	Cho Yongt'ae
한경태	Han Kyŏngtae
환희	Hwanhŭi
염고은	Yŏm Koŭn
최진호	Ch'oi Chinho
최덕주	Ch'oe Tŏkchu
조세권	Cho Se-kwŏn
김현아	Kim Hyŏn-a
배용균	Pae Yonggyun
임창민	Rim Ch'angmin
최형우	Ch'oe Hyŏngu
채병용	Ch'ae Pyŏngnyong
이병규	Ri Pyŏnggyu
안칠현	An Ch'irhyŏn
김영길	Kim Yŏng-gil
이봉주	I Pŏng-Chu
김민기	Kim Min-ki
변재섭	Pyŏn Chaesŏp
정형돈	Chŏng Hyŏngdon
김용익	Kim Yong'ik
김숙	Kim Suk
조동현	Cho Tonghyŏn
황도연	Hwang Do-Yŏn
김용대	Kim Yongdae
김인숙	Kim Insuk
홍종우	Hong Chong-u
이정희	Yi Chŏnghŭi
조형준	Cho Hyŏngjun
지코	Chik'o
최규백	Ch'oe Kyu-baek
박지훈	Pak Chi-hun
조희제	Cho Hŭije
심정수	Sim Chŏng-su
안성훈	An Sŏnghun
배수아	Pae Sua
양요섭	Yang Yo-sŏp
이호준	I Hojun
김학범	Kim Hak-pŏm
이현재	Yi Hyŏnjae
김수근	Kim Sugŭn
채지훈	Ch'ae Chi-hun
주세종	Chu Sejong
안한봉	An Han-bong
신지호	Shin Chiho
김성민	Kim Sŏngmin
나르샤	Narŭsya
박희영	Pak Hŭi-yŏng
이보근	Ri Po-gŭn
방승환	Pang Sŭng-hwan
이서구	Yi Seogu
신혜정	Sin Hye-jŏng
남창희	Nam Ch'anghŭi
이은정	Yi Ŭnjŏng
문국현	Mun Kuk-hyŏn
엄효원	Ŏm Hyowŏn
강진규	Kang Chin-gyu
정몽헌	Chŏng Monghŏn
지동원	Chi Tongwŏn
양의지	Yang Ŭiji
김귀화	Kim Kwi-hwa
이민진	Yi Minchin
전기영	Chŏn Ki-yŏng
정용기	Chŏng Yonggi
하태균	Ha T'aegyun
민도희	Min To-hŭi
김보경	Kim Pogyŏng
윤성환	Yun Sŏng-hwan
김태형	Kim T'ae-hyŏng
황보 관	Hwangpo Kwan
안병근	An Byŏng-kŭn
김형수	Kim Hyŏngsu
김영호	Kim Yŏngho
유라	Yura
이현주	Ri Hyŏnju
김재호	Kim Chaeho
한창훈	Han Ch'anghun
임정희	Im Chŏnghŭi
박성화	Pak Sŏng-hwa
이창호	Yi Ch'ang-ho
호현주	Ho Hyŏnju
장정연	Chang Chŏngyŏn
황재균	Hwang Chaegyun
하대성	Ha Taesŏng
이동현	Yi Dong-hyŏn
황연석	Hwang Yŏn-sŏk
원종현	Wŏn Chong-hyŏn
김광규	Kim Kwang'gyu
노상래	No Sang-rae
김려욱	Kim Ryŏ-uk
김혜린	Kim Hyerin
김삼락	Kim Samnak
김희철	Kim Hŭich'ŏl
박소연	Pak So-yŏn
이태영	Ri T'aeyŏng
용성	Yongsŏng
김재경	Kim Chae-gyŏng
김정관	Kim Chŏnggwan
장성호	Chang Sŏng-ho
김민성	Kim Minsŏng
고재욱	Ko Chae-uk
앵무	Aengmu
이장무	I Chang-mu
한송이	Han Song-i
이승우	Ri Sŭngu
박남규	Pak Namgyu
반기문	Pan Kimun
이창우	Yi Ch'ang-u
안성빈	An Sŏng-Pin
노 현석	No Hyŏn-sŏk
전광진	Chŏn Kwangjin
이현수	Yi Hyŏnsu
정해성	Chŏng Hae-sŏng
전이경	Chŏn Rigyŏng
김도훈	Kim To-hun
강준우	Kang Chun-u
구대성	Ku Tae-sŏng
헌경왕후	Hŏn’gyŏng wangu
안재곤	An Chae-Kon
한상운	Han Sang-un
전준호	Chŏn Chunho
김성헌	Kim Sŏng-hŏn
강영식	Kang Yŏng-sik
노진혁	Ro Chinhyŏk
이동필	I Tongp'il
한대수	Han Taesu
신지민	Sin Chi-min
박현기	Pak Hyŏn'gi
정주현	Chŏng Chuhyŏn
길영아	Kil Yŏng-a
성지	Sŏngji
김민규	Kim Min-kyu
조병국	Cho Pyŏngkuk
선지	Sŏnji
노무현	No Muhyŏn
강지영	Kang Chi-yŏng
고원준	Ko Wŏnjun
윤남한	Yun Namhan
송은범	Song Ŭnbŏm
차범근	Ch'a Pŏmgŭn
전광우	Chǒn Kwang'u
김용희	Kim Yonghŭi
배기종	Pae Kichong
서진석	Sŏ Chinsŏk
하정헌	Ha Jŏng-Hŏn
백선엽	Paek Sŏnyŏp
정우인	Chŏng Uin
정명오	Chŏng Myŏng-o
윤제균	Yun Jekyun
이봉창	Yi Pongch'ang
백홍석	Baek Hong-seok
최철우	Ch'oe Ch'ŏl-u
염기훈	Yŏm Kihun
박종우	Pak Chongu
김혁	Kim Hyŏk
최윤희	Ch'oe Yunhŭi
하형주	Ha Hyŏngju
송민순	Song Minsun
부용찬	Pu Yongch'an
신능균	Sin Nǔng-kyun
이경근	Yi Kyeŏng-kŭn
신동우	Sin Tong-u
최수영	Ch'oe Suyŏng
박현범	Pak Hyŏn-bŏm
황찬성	Hwang Ch'ansŏng
조성모	Cho Sŏngmo
이순옥	Ri Sun-ok
이회성	Ri Hoesŏng
서복섭	Suh Bok-Sub
김유정	Kim Yujŏng
간미연	Kan Miyŏn
유일한	Ryu Ilhan
박세학	Pak Segi-hak
구교동	Ku Kyodong
김호	Kim Ho
백민석	Paek Min-sŏk
수지	Su-chi
한태유	Han T'aeyu
임태훈	Rim T'aehun
진은숙	Chin Ŭnsuk
이영진	Ri Yŏngjin
강귀태	Kang Kwit'ae
조원진	Cho Wŏnjin
조준호	Cho Chun-ho
김재엽	Kim Chae-yŏp
권혁	Kwŏn Hyŏk
류시훈	Ryu Si-hun
서재창	Sŏ Chaechang
안현범	An Hyŏnpŏm
류철균	Ryu Ch'ŏlgyun
최윤	Ch'oe Yun
곽현화	Kwak Hyŏnhwa
나웅배	Ra Ung-bae
표현명	P'yo Hyǒnmyǒng
서상철	Sŏ Sang-ch'ŏl
원우영	Wŏn Uyŏng
서용덕	Sŏ Yong-tŏk
용당	Yongdang
김수봉	Kim Subong
송창식	Song Ch'ang-sik
심수봉	Sim Su-bong
조진생	Cho Chinsaeng
박진만	Pak Chin-man
편혜영	P'yŏn Hyeyŏng
이상효	Yi Sang-hyo
연하	Yŏnha
박유천	Pak Yuch'ŏn
김경애	Kim Kyŏng-ae
최지현	Ch'oe Chi-hyŏn
이재성	Ri Chaesŏng
이영진	Yi Yǒngjin
정진석	Chŏng Chinsŏk
김이용	Kim Yi-yong
최진한	Ch'oe Chin-han
이재면	Yi Chae-Myŏn
정정숙	Chŏng Chŏngsuk
이양지	I Yangji
도동현	To Dongyŏn
백수린	Paek Surin
김상식	Kim Sangshik
백승철	Paek Sŭngch'ŏl
오세훈	O Sehun
임기영	Im Ki-yŏng
정현종	Chŏng Hyŏn-jong
김지원	Kim Chiwŏn
김은국	Kim Ǔn'guk
최상림	Ch’oe Sang-rim
전인지	Jeon Inchi
김종혁	Kim Chonghyŏk
이한빈	Ri Han-bin
심수창	Sim Su-ch'ang
홍영후	Hong Yonghu
오재원	O Chaewŏn
임지순	Im Chisun
김규대	Kim Kyudae
나리	Ra Ri
양현석	Yang Hyŏn-sŏk
이특	It'ŭk
변희재	Pyŏn Hŭichae
손나은	Son Na-ŭn
이세돌	Ri Sedol
양세형	Yang Se-hyŏng
방현석	Pang Hyŏnsŏk
한상훈	Han Sang-hun
이경훈	Ri Kyŏnghun
김진성	Kim Chinsŏng
박석진	Pak Sŏkchin
김영무	Kim Yŏngmu
김려령	Kim Yŏryŏng
김경아	Kim Kyŏng-a
이태원	Yi T'ae-wŏn